'    #####          '
'    #...#          '
'    #$..#          '
'  ###..$##         '
'  #..$.$.#         '
'###.#.##.#   ######'
'#...#.##.#####..%%#'
'#.$..$..........%%#'
'#####.###.#@##..%%#'
'    #.....#########'
'    #######        '